1111111111
1````111@1
1`&``111`1
1````111`1
1`11`111`1
11`1`111`1
1````````1
1111111111