111111111111
11@``11`1``1
1@11`1``1``1
1`1``11````1
1`1`11``11`1
1`1`1``1```1
1&1```1`&111
1111111``111
111111111111