1111111111111
1```````````1
1@XXXXXXXXX`1
1`X&````````1
1111111111111