1111111111111
1``````````&1
1@XXXXXXXXXX1
1@1XX11111111
1``````````&1
1111111111111