11111111111
1```````XX1
1@``XXX```1
11`1XXXX`&1
1@`````X`&1
1```XX````1
11111111111