1111111111111
1@X1&````1XX1
1```1```````1
1```1XX`````1
1@1`````1```1
1X1`X1`X&```1
1111111111111