9 7
111111111
100000001
100000001
1@00000&1
100000001
100000001
111111111