11111111111111111111
11111111111111&11111
11111111111111`11111
11111111111111`11111
1@````````2`````1111
1`11111111`1111`1111
1`1111111111111`1111
11111111111111111111